Soft Currency Gain	Soft Currency Spend	Soft Currency Balance	Hard Currency Gain	Hard Currency Spend	Hard Currency Balance	Heart Gain	Heart Spend	Heart Balance	Food Gain	Food Spend	Food Balance	Worlds Gain	Worlds Spend	Worlds Balance	Upgrade Gain	Upgrade Spend	Upgrade Balance	Level Gain	Level Spend	Level Balance	Videos Gain	Videos Spend	Videos Balance	Skill level Gain	Skill level Spend	Skill level Balance	IAPs Gain	IAPs Spend	IAPs Balance	IAP spend $ Gain	IAP spend $ Spend	IAP spend $ Balance	Additional SC Gain	Additional SC Spend	Additional SC Balance	Get Heart Video Gain	Get Heart Video Spend	Get Heart Video Balance	Double Reward Videos Gain	Double Reward Videos Spend	Double Reward Videos Balance	Gacha Wheel Videos Gain	Gacha Wheel Videos Spend	Gacha Wheel Videos Balance	Get Gems Videos Gain	Get Gems Videos Spend	Get Gems Videos Balance
5141.576734128279	4174.4	967.1767341282778	39.35622940752202	26.24	13.116229407521976	5.08	5.08	0.0	10.56	0.0	10.56	0.0	0.0	0.0	10.56	0.0	10.56	5.3	0.0	5.3	1.43	0.0	1.43	0.0	0.0	0.0	0.0	0.0	0.0	0.0	0.0	0.0	0.0	0.0	0.0	0.05	0.0	0.05	0.25	0.0	0.25	0.47	0.0	0.47	0.66	0.0	0.66
5616.362395952935	4112.4	2471.1391300812147	18.279213402148933	9.76	21.63544280967093	5.1	5.1	0.0	3.9	0.0	14.46	0.0	0.0	0.0	3.9	0.0	14.46	2.18	0.0	7.48	1.11	0.0	2.54	0.0	0.0	0.0	0.0	0.0	0.0	0.0	0.0	0.0	0.0	0.0	0.0	0.07	0.0	0.12	0.26	0.0	0.51	0.38	0.0	0.85	0.4	0.0	1.06
6388.684259417712	6069.06	2790.763389498927	13.77853363492262	13.46	21.95397644459355	5.05	5.05	0.0	4.09	0.0	18.55	0.2	0.0	0.2	4.09	0.0	18.55	1.98	0.0	9.46	0.84	0.0	3.38	0.0	0.0	0.0	0.0	0.0	0.0	0.0	0.0	0.0	0.0	0.0	0.0	0.04	0.0	0.16	0.22	0.0	0.73	0.25	0.0	1.1	0.33	0.0	1.39
9030.853660730145	8861.35	2960.2670502290734	16.989533581203965	29.51	9.433510025797501	5.02	5.02	0.0	5.44	0.0	23.99	0.33	0.0	0.53	5.44	0.0	23.99	2.98	0.0	12.44	0.81	0.0	4.19	0.0	0.0	0.0	0.0	0.0	0.0	0.0	0.0	0.0	0.0	0.0	0.0	0.02	0.0	0.18	0.21	0.0	0.94	0.28	0.0	1.38	0.3	0.0	1.69
9518.630041397482	8638.74	3840.157091626557	14.39639532947792	11.67	12.15990535527542	5.03	5.03	0.0	4.25	0.0	28.24	0.23	0.0	0.76	4.25	0.0	28.24	2.23	0.0	14.67	0.93	0.0	5.12	0.0	0.0	0.0	0.0	0.0	0.0	0.0	0.0	0.0	0.0	0.0	0.0	0.02	0.0	0.2	0.19	0.0	1.13	0.42	0.0	1.8	0.3	0.0	1.99
10609.912388158997	9578.85	4871.219479785549	14.922788032812234	9.72	17.362693388087663	5.07	5.07	0.0	3.7	0.0	31.94	0.24	0.0	1.0	3.7	0.0	31.94	2.06	0.0	16.73	1.24	0.0	6.36	0.0	0.0	0.0	0.0	0.0	0.0	0.0	0.0	0.0	0.0	0.0	0.0	0.07	0.0	0.27	0.27	0.0	1.4	0.41	0.0	2.21	0.49	0.0	2.48
10469.333708671451	8115.92	7224.633188456998	12.364285247143753	8.22	21.5069786352314	5.1	5.1	0.0	2.43	0.0	34.37	0.0	0.0	1.0	2.43	0.0	34.37	1.24	0.0	17.97	1.0	0.0	7.36	0.0	0.0	0.0	0.0	0.0	0.0	0.0	0.0	0.0	0.0	0.0	0.0	0.07	0.0	0.34	0.25	0.0	1.65	0.35	0.0	2.56	0.33	0.0	2.81
10225.35009422277	7746.11	9703.873282679775	9.87275154537013	2.42	28.95973018060152	5.07	5.07	0.0	1.3	0.0	35.67	0.0	0.0	1.0	1.3	0.0	35.67	0.66	0.0	18.63	1.01	0.0	8.37	0.0	0.0	0.0	0.0	0.0	0.0	0.0	0.0	0.0	0.0	0.0	0.0	0.07	0.0	0.41	0.26	0.0	1.91	0.36	0.0	2.92	0.32	0.0	3.13
9904.935759976868	7242.93	12365.87904265665	7.548257189429421	2.16	34.34798737003096	5.07	5.07	0.0	1.09	0.0	36.76	0.03	0.0	1.03	1.09	0.0	36.76	0.46	0.0	19.09	0.84	0.0	9.21	0.0	0.0	0.0	0.0	0.0	0.0	0.0	0.0	0.0	0.0	0.0	0.0	0.07	0.0	0.48	0.33	0.0	2.24	0.24	0.0	3.16	0.2	0.0	3.33
14502.691970166807	11419.68	15448.891012823451	13.109354481653995	18.99	28.467341851684946	5.05	5.05	0.0	2.95	0.0	39.71	0.23	0.0	1.26	2.95	0.0	39.71	1.49	0.0	20.58	1.03	0.0	10.24	0.0	0.0	0.0	0.0	0.0	0.0	0.0	0.0	0.0	0.0	0.0	0.0	0.05	0.0	0.53	0.33	0.0	2.57	0.34	0.0	3.5	0.31	0.0	3.64
28700.34798414925	30962.57	13186.668996972712	27.740186359650323	40.32	15.88752821133528	5.04	5.04	0.0	7.03	0.0	46.74	0.5	0.0	1.76	7.03	0.0	46.74	3.82	0.0	24.4	1.2	0.0	11.44	0.0	0.0	0.0	0.0	0.0	0.0	0.0	0.0	0.0	0.0	0.0	0.0	0.04	0.0	0.57	0.29	0.0	2.86	0.43	0.0	3.93	0.44	0.0	4.08
24877.357541528603	23266.87	14797.15653850131	18.936824819502636	18.51	16.31435303083792	5.1	5.1	0.0	3.8	0.0	50.54	0.22	0.0	1.98	3.8	0.0	50.54	2.17	0.0	26.57	0.96	0.0	12.4	0.0	0.0	0.0	0.0	0.0	0.0	0.0	0.0	0.0	0.0	0.0	0.0	0.09	0.0	0.66	0.16	0.0	3.02	0.37	0.0	4.3	0.34	0.0	4.42
21747.06977510918	19531.23	17012.9963136105	13.356649656576767	6.54	23.131002687414686	5.06	5.06	0.0	1.63	0.0	52.17	0.02	0.0	2.0	1.63	0.0	52.17	0.92	0.0	27.49	0.88	0.0	13.28	0.0	0.0	0.0	0.0	0.0	0.0	0.0	0.0	0.0	0.0	0.0	0.0	0.06	0.0	0.72	0.2	0.0	3.22	0.3	0.0	4.6	0.32	0.0	4.74
22773.24040712401	21162.24	18623.996720734518	11.726663880693561	5.01	29.84766656810824	5.07	5.07	0.0	1.31	0.0	53.48	0.0	0.0	2.0	1.31	0.0	53.48	0.71	0.0	28.2	0.84	0.0	14.12	0.0	0.0	0.0	0.0	0.0	0.0	0.0	0.0	0.0	0.0	0.0	0.0	0.07	0.0	0.79	0.19	0.0	3.41	0.28	0.0	4.88	0.3	0.0	5.04
21059.16741997222	19393.9	20289.264140706728	7.7499583255864914	1.26	36.337624893694745	5.07	5.07	0.0	0.86	0.0	54.34	0.0	0.0	2.0	0.86	0.0	54.34	0.36	0.0	28.56	0.89	0.0	15.01	0.0	0.0	0.0	0.0	0.0	0.0	0.0	0.0	0.0	0.0	0.0	0.0	0.06	0.0	0.85	0.31	0.0	3.72	0.25	0.0	5.13	0.27	0.0	5.31
21244.174423999848	16726.39	24807.04856470661	7.209004843565639	0.21	43.33662973726039	5.06	5.06	0.0	0.62	0.0	54.96	0.0	0.0	2.0	0.62	0.0	54.96	0.29	0.0	28.85	0.77	0.0	15.78	0.0	0.0	0.0	0.0	0.0	0.0	0.0	0.0	0.0	0.0	0.0	0.0	0.06	0.0	0.91	0.2	0.0	3.92	0.26	0.0	5.39	0.25	0.0	5.56
19579.070298183047	13872.53	30513.588862889632	6.153060228979108	0.0	49.48968996623951	5.06	5.06	0.0	0.47	0.0	55.43	0.0	0.0	2.0	0.47	0.0	55.43	0.06	0.0	28.91	1.06	0.0	16.84	0.0	0.0	0.0	0.0	0.0	0.0	0.0	0.0	0.0	0.0	0.0	0.0	0.04	0.0	0.95	0.42	0.0	4.34	0.3	0.0	5.69	0.3	0.0	5.86
22536.799955101473	16449.14	36601.24881799113	7.157889783719733	7.46	49.187579749959205	5.04	5.04	0.0	1.1	0.0	56.53	0.1	0.0	2.1	1.1	0.0	56.53	0.54	0.0	29.45	0.65	0.0	17.49	0.0	0.0	0.0	0.0	0.0	0.0	0.0	0.0	0.0	0.0	0.0	0.0	0.04	0.0	0.99	0.22	0.0	4.56	0.21	0.0	5.9	0.18	0.0	6.04
34626.19778344061	42573.8	28653.64660143171	12.261416504300438	29.55	31.898996254259654	5.08	5.08	0.0	3.48	0.0	60.01	0.43	0.0	2.53	3.48	0.0	60.01	2.0	0.0	31.45	0.93	0.0	18.42	0.0	0.0	0.0	0.0	0.0	0.0	0.0	0.0	0.0	0.0	0.0	0.0	0.07	0.0	1.06	0.18	0.0	4.74	0.32	0.0	6.22	0.36	0.0	6.4
35721.810007380496	44789.95	19585.50660881221	12.695783184862323	29.45	15.144779439121969	5.09	5.09	0.0	3.86	0.0	63.87	0.36	0.0	2.89	3.86	0.0	63.87	2.11	0.0	33.56	1.1	0.0	19.52	0.0	0.0	0.0	0.0	0.0	0.0	0.0	0.0	0.0	0.0	0.0	0.0	0.07	0.0	1.13	0.3	0.0	5.04	0.36	0.0	6.58	0.37	0.0	6.77
27240.830507203027	23702.69	23123.647116015236	8.726258872337011	11.49	12.381038311458974	5.08	5.08	0.0	1.64	0.0	65.51	0.08	0.0	2.97	1.64	0.0	65.51	0.84	0.0	34.4	0.96	0.0	20.48	0.0	0.0	0.0	0.0	0.0	0.0	0.0	0.0	0.0	0.0	0.0	0.0	0.08	0.0	1.21	0.28	0.0	5.32	0.31	0.0	6.89	0.29	0.0	7.06
26642.43663694585	21470.66	28295.423752961113	8.110970072728168	8.45	12.042008384187143	5.06	5.06	0.0	1.19	0.0	66.7	0.03	0.0	3.0	1.19	0.0	66.7	0.54	0.0	34.94	0.72	0.0	21.2	0.0	0.0	0.0	0.0	0.0	0.0	0.0	0.0	0.0	0.0	0.0	0.0	0.06	0.0	1.27	0.19	0.0	5.51	0.25	0.0	7.14	0.22	0.0	7.28
30129.950723322174	23490.82	34934.55447628331	9.55001868988075	9.22	12.372027074067894	5.06	5.06	0.0	1.1	0.0	67.8	0.0	0.0	3.0	1.1	0.0	67.8	0.56	0.0	35.5	0.76	0.0	21.96	0.0	0.0	0.0	0.0	0.0	0.0	0.0	0.0	0.0	0.0	0.0	0.0	0.05	0.0	1.32	0.14	0.0	5.65	0.3	0.0	7.44	0.27	0.0	7.55
32986.487333603065	25620.09	42300.95180988635	9.996641808728882	7.89	14.47866888279677	5.02	5.02	0.0	0.96	0.0	68.76	0.0	0.0	3.0	0.96	0.0	68.76	0.46	0.0	35.96	0.87	0.0	22.83	0.0	0.0	0.0	0.0	0.0	0.0	0.0	0.0	0.0	0.0	0.0	0.0	0.02	0.0	1.34	0.24	0.0	5.89	0.29	0.0	7.73	0.32	0.0	7.87
39656.081500259155	32614.09	49342.94331014553	12.475499528232966	7.39	19.564168411029744	5.04	5.04	0.0	0.9	0.0	69.66	0.0	0.0	3.0	0.9	0.0	69.66	0.54	0.0	36.5	0.96	0.0	23.79	0.0	0.0	0.0	0.0	0.0	0.0	0.0	0.0	0.0	0.0	0.0	0.0	0.03	0.0	1.37	0.32	0.0	6.21	0.33	0.0	8.06	0.28	0.0	8.15
41741.22747137227	35823.52	55260.650781517805	11.565912133698442	6.54	24.590080544728163	5.1	5.1	0.0	0.83	0.0	70.49	0.0	0.0	3.0	0.83	0.0	70.49	0.45	0.0	36.95	0.87	0.0	24.66	0.0	0.0	0.0	0.0	0.0	0.0	0.0	0.0	0.0	0.0	0.0	0.0	0.08	0.0	1.45	0.2	0.0	6.41	0.34	0.0	8.4	0.25	0.0	8.4
46628.34621397242	35449.52	66439.47699549021	10.34096944685745	4.05	30.88104999158562	5.05	5.05	0.0	0.63	0.0	71.12	0.0	0.0	3.0	0.63	0.0	71.12	0.5	0.0	37.45	0.69	0.0	25.35	0.0	0.0	0.0	0.0	0.0	0.0	0.0	0.0	0.0	0.0	0.0	0.0	0.05	0.0	1.5	0.23	0.0	6.64	0.21	0.0	8.61	0.2	0.0	8.6
49299.92411728143	43152.88	72586.52111277163	8.690578009355924	2.7	36.871628000941534	5.06	5.06	0.0	0.62	0.0	71.74	0.0	0.0	3.0	0.62	0.0	71.74	0.44	0.0	37.89	0.82	0.0	26.17	0.0	0.0	0.0	0.0	0.0	0.0	0.0	0.0	0.0	0.0	0.0	0.0	0.06	0.0	1.56	0.26	0.0	6.9	0.23	0.0	8.84	0.27	0.0	8.87
49100.55669704037	41663.0	80024.07780981199	7.946332566726953	0.81	44.00796056766846	5.09	5.09	0.0	0.43	0.0	72.17	0.0	0.0	3.0	0.43	0.0	72.17	0.32	0.0	38.21	0.95	0.0	27.12	0.0	0.0	0.0	0.0	0.0	0.0	0.0	0.0	0.0	0.0	0.0	0.0	0.09	0.0	1.65	0.34	0.0	7.24	0.23	0.0	9.07	0.29	0.0	9.16
50906.40006629185	53997.33	76933.14787610385	7.112425876265105	0.0	51.12038644393358	5.09	5.09	0.0	0.47	0.0	72.64	0.0	0.0	3.0	0.47	0.0	72.64	0.3	0.0	38.51	1.0	0.0	28.12	0.0	0.0	0.0	0.0	0.0	0.0	0.0	0.0	0.0	0.0	0.0	0.0	0.07	0.0	1.72	0.29	0.0	7.53	0.31	0.0	9.38	0.33	0.0	9.49
45324.78842425486	31801.74	90456.19630035877	5.62015551778079	0.0	56.7405419617144	5.05	5.05	0.0	0.26	0.0	72.9	0.0	0.0	3.0	0.26	0.0	72.9	0.11	0.0	38.62	0.79	0.0	28.91	0.0	0.0	0.0	0.0	0.0	0.0	0.0	0.0	0.0	0.0	0.0	0.0	0.04	0.0	1.76	0.23	0.0	7.76	0.3	0.0	9.68	0.22	0.0	9.71
45198.159922864754	48529.94	87124.41622322352	5.579517687861951	0.0	62.320059649576315	5.04	5.04	0.0	0.36	0.0	73.26	0.0	0.0	3.0	0.36	0.0	73.26	0.1	0.0	38.72	0.65	0.0	29.56	0.0	0.0	0.0	0.0	0.0	0.0	0.0	0.0	0.0	0.0	0.0	0.0	0.03	0.0	1.79	0.17	0.0	7.93	0.23	0.0	9.91	0.22	0.0	9.93
48136.376756981255	59767.66	75493.1329802048	5.807460576344807	0.0	68.12752022592113	5.04	5.04	0.0	0.44	0.0	73.7	0.0	0.0	3.0	0.44	0.0	73.7	0.13	0.0	38.85	0.74	0.0	30.3	0.0	0.0	0.0	0.0	0.0	0.0	0.0	0.0	0.0	0.0	0.0	0.0	0.04	0.0	1.83	0.22	0.0	8.15	0.25	0.0	10.16	0.23	0.0	10.16
47349.89154081749	33751.86	89091.1645210223	5.636548711245069	0.0	73.7640689371662	5.08	5.08	0.0	0.24	0.0	73.94	0.0	0.0	3.0	0.24	0.0	73.94	0.05	0.0	38.9	0.93	0.0	31.23	0.0	0.0	0.0	0.0	0.0	0.0	0.0	0.0	0.0	0.0	0.0	0.0	0.08	0.0	1.91	0.26	0.0	8.41	0.32	0.0	10.48	0.27	0.0	10.43
48681.74446666041	49547.54	88225.36898768274	5.735984899993103	1.84	77.66005383715932	5.04	5.04	0.0	0.4	0.0	74.34	0.02	0.0	3.02	0.4	0.0	74.34	0.11	0.0	39.01	0.82	0.0	32.05	0.0	0.0	0.0	0.0	0.0	0.0	0.0	0.0	0.0	0.0	0.0	0.0	0.04	0.0	1.95	0.26	0.0	8.67	0.26	0.0	10.74	0.26	0.0	10.69
49424.356042020256	48311.58	89338.14502970304	5.961715506820472	4.6	79.02176934397977	5.06	5.06	0.0	0.51	0.0	74.85	0.04	0.0	3.06	0.51	0.0	74.85	0.16	0.0	39.17	0.88	0.0	32.93	0.0	0.0	0.0	0.0	0.0	0.0	0.0	0.0	0.0	0.0	0.0	0.0	0.05	0.0	2.0	0.22	0.0	8.89	0.31	0.0	11.05	0.3	0.0	10.99
57684.029965181246	54184.27	92837.90499488437	7.530186087698448	21.16	65.39195543167826	5.04	5.04	0.0	1.18	0.0	76.03	0.22	0.0	3.28	1.18	0.0	76.03	0.74	0.0	39.91	0.81	0.0	33.74	0.0	0.0	0.0	0.0	0.0	0.0	0.0	0.0	0.0	0.0	0.0	0.0	0.04	0.0	2.04	0.22	0.0	9.11	0.31	0.0	11.36	0.24	0.0	11.23
58510.85684300824	83567.66	67781.1018378927	8.492504027115315	34.04	39.844459458793565	5.06	5.06	0.0	1.79	0.0	77.82	0.3	0.0	3.58	1.79	0.0	77.82	1.05	0.0	40.96	0.89	0.0	34.63	0.0	0.0	0.0	0.0	0.0	0.0	0.0	0.0	0.0	0.0	0.0	0.0	0.06	0.0	2.1	0.26	0.0	9.37	0.34	0.0	11.7	0.23	0.0	11.46
50236.35200533351	71440.27	46577.183843226194	8.506587014264973	23.92	24.43104647305852	5.06	5.06	0.0	1.56	0.0	79.38	0.27	0.0	3.85	1.56	0.0	79.38	1.02	0.0	41.98	0.86	0.0	35.49	0.0	0.0	0.0	0.0	0.0	0.0	0.0	0.0	0.0	0.0	0.0	0.0	0.05	0.0	2.15	0.27	0.0	9.64	0.25	0.0	11.95	0.29	0.0	11.75
35250.81276170511	30927.59	50900.40660493132	6.453272251708046	7.67	23.214318724766585	5.06	5.06	0.0	0.67	0.0	80.05	0.05	0.0	3.9	0.67	0.0	80.05	0.41	0.0	42.39	0.79	0.0	36.28	0.0	0.0	0.0	0.0	0.0	0.0	0.0	0.0	0.0	0.0	0.0	0.0	0.05	0.0	2.2	0.27	0.0	9.91	0.25	0.0	12.2	0.22	0.0	11.97
33291.51875978586	29259.04	54932.88536471711	5.961141917340526	3.28	25.895460642107114	5.1	5.1	0.0	0.5	0.0	80.55	0.06	0.0	3.96	0.5	0.0	80.55	0.26	0.0	42.65	0.88	0.0	37.16	0.0	0.0	0.0	0.0	0.0	0.0	0.0	0.0	0.0	0.0	0.0	0.0	0.09	0.0	2.29	0.27	0.0	10.18	0.28	0.0	12.48	0.24	0.0	12.21
32472.424867520887	31515.53	55889.780232237994	6.010608244054968	6.97	24.936068886162083	5.04	5.04	0.0	0.67	0.0	81.22	0.02	0.0	3.98	0.67	0.0	81.22	0.26	0.0	42.91	0.89	0.0	38.05	0.0	0.0	0.0	0.0	0.0	0.0	0.0	0.0	0.0	0.0	0.0	0.0	0.03	0.0	2.32	0.28	0.0	10.46	0.26	0.0	12.74	0.32	0.0	12.53
35498.79141283709	30308.16	61080.411645075095	6.31517548460982	11.89	19.3612443707719	5.07	5.07	0.0	0.64	0.0	81.86	0.02	0.0	4.0	0.64	0.0	81.86	0.26	0.0	43.17	0.89	0.0	38.94	0.0	0.0	0.0	0.0	0.0	0.0	0.0	0.0	0.0	0.0	0.0	0.0	0.06	0.0	2.38	0.31	0.0	10.77	0.2	0.0	12.94	0.32	0.0	12.85
35368.32656785289	23506.03	72942.70821292803	5.802693364746566	5.33	19.83393773551846	5.05	5.05	0.0	0.41	0.0	82.27	0.0	0.0	4.0	0.41	0.0	82.27	0.18	0.0	43.35	0.84	0.0	39.78	0.0	0.0	0.0	0.0	0.0	0.0	0.0	0.0	0.0	0.0	0.0	0.0	0.05	0.0	2.43	0.24	0.0	11.01	0.3	0.0	13.24	0.25	0.0	13.1
36634.66085920459	25308.5	84268.8690721326	5.8187142467973	3.69	21.96265198231578	5.04	5.04	0.0	0.39	0.0	82.66	0.0	0.0	4.0	0.39	0.0	82.66	0.2	0.0	43.55	0.78	0.0	40.56	0.0	0.0	0.0	0.0	0.0	0.0	0.0	0.0	0.0	0.0	0.0	0.0	0.03	0.0	2.46	0.25	0.0	11.26	0.27	0.0	13.51	0.23	0.0	13.33
39055.89844119202	38206.59	85118.17751332461	5.838754419328839	2.05	25.751406401644605	5.07	5.07	0.0	0.36	0.0	83.02	0.0	0.0	4.0	0.36	0.0	83.02	0.15	0.0	43.7	0.81	0.0	41.37	0.0	0.0	0.0	0.0	0.0	0.0	0.0	0.0	0.0	0.0	0.0	0.0	0.07	0.0	2.53	0.3	0.0	11.56	0.21	0.0	13.72	0.23	0.0	13.56
43304.90001237303	46456.05	81967.02752569769	6.220430287189788	5.39	26.5818366888344	5.04	5.04	0.0	0.48	0.0	83.5	0.0	0.0	4.0	0.48	0.0	83.5	0.24	0.0	43.94	0.71	0.0	42.08	0.0	0.0	0.0	0.0	0.0	0.0	0.0	0.0	0.0	0.0	0.0	0.0	0.04	0.0	2.57	0.21	0.0	11.77	0.25	0.0	13.97	0.21	0.0	13.77
45829.11719213206	34235.19	93560.95471782975	6.351557144704629	4.58	28.35339383353902	5.05	5.05	0.0	0.42	0.0	83.92	0.0	0.0	4.0	0.42	0.0	83.92	0.26	0.0	44.2	0.82	0.0	42.9	0.0	0.0	0.0	0.0	0.0	0.0	0.0	0.0	0.0	0.0	0.0	0.0	0.03	0.0	2.6	0.24	0.0	12.01	0.23	0.0	14.2	0.32	0.0	14.09
52627.1018897445	45000.52	101187.53660757426	6.777041864391589	10.88	24.250435697930612	5.02	5.02	0.0	0.64	0.0	84.56	0.0	0.0	4.0	0.64	0.0	84.56	0.34	0.0	44.54	0.87	0.0	43.77	0.0	0.0	0.0	0.0	0.0	0.0	0.0	0.0	0.0	0.0	0.0	0.0	0.02	0.0	2.62	0.32	0.0	12.33	0.24	0.0	14.44	0.29	0.0	14.38
62705.50767095237	69934.75	93958.29427852666	6.94371226672024	9.66	21.534147964650845	5.04	5.04	0.0	0.68	0.0	85.24	0.0	0.0	4.0	0.68	0.0	85.24	0.37	0.0	44.91	1.02	0.0	44.79	0.0	0.0	0.0	0.0	0.0	0.0	0.0	0.0	0.0	0.0	0.0	0.0	0.03	0.0	2.65	0.33	0.0	12.66	0.33	0.0	14.77	0.33	0.0	14.71
58457.21969270171	41159.31	111256.20397122829	6.430184269451209	7.98	19.98433223410206	5.08	5.08	0.0	0.48	0.0	85.72	0.0	0.0	4.0	0.48	0.0	85.72	0.23	0.0	45.14	0.92	0.0	45.71	0.0	0.0	0.0	0.0	0.0	0.0	0.0	0.0	0.0	0.0	0.0	0.0	0.04	0.0	2.69	0.31	0.0	12.97	0.21	0.0	14.98	0.36	0.0	15.07
58592.313014848965	50382.82	119465.69698607722	6.116748157917771	3.77	22.33108039201982	5.03	5.03	0.0	0.47	0.0	86.19	0.0	0.0	4.0	0.47	0.0	86.19	0.21	0.0	45.35	0.75	0.0	46.46	0.0	0.0	0.0	0.0	0.0	0.0	0.0	0.0	0.0	0.0	0.0	0.0	0.03	0.0	2.72	0.2	0.0	13.17	0.24	0.0	15.22	0.28	0.0	15.35
61922.30393794378	59345.64	122042.36092402093	6.025868886495731	4.2	24.156949278515558	5.06	5.06	0.0	0.46	0.0	86.65	0.0	0.0	4.0	0.46	0.0	86.65	0.16	0.0	45.51	0.85	0.0	47.31	0.0	0.0	0.0	0.0	0.0	0.0	0.0	0.0	0.0	0.0	0.0	0.0	0.06	0.0	2.78	0.29	0.0	13.46	0.24	0.0	15.46	0.26	0.0	15.61
60016.49339083203	26254.12	155804.73431485286	5.750675854667207	2.1	27.807625133182768	5.06	5.06	0.0	0.23	0.0	86.88	0.0	0.0	4.0	0.23	0.0	86.88	0.09	0.0	45.6	0.83	0.0	48.14	0.0	0.0	0.0	0.0	0.0	0.0	0.0	0.0	0.0	0.0	0.0	0.0	0.05	0.0	2.83	0.25	0.0	13.71	0.24	0.0	15.7	0.29	0.0	15.9
60465.276011290836	30608.21	185661.80032614365	5.664783150293136	0.0	33.47240828347588	5.04	5.04	0.0	0.19	0.0	87.07	0.0	0.0	4.0	0.19	0.0	87.07	0.08	0.0	45.68	0.74	0.0	48.88	0.0	0.0	0.0	0.0	0.0	0.0	0.0	0.0	0.0	0.0	0.0	0.0	0.03	0.0	2.86	0.2	0.0	13.91	0.27	0.0	15.97	0.24	0.0	16.14
68319.22792348893	70278.42	183702.60824963253	8.372377848448215	5.13	36.7147861319241	5.06	5.06	0.0	0.37	0.0	87.44	0.0	0.0	4.0	0.37	0.0	87.44	0.14	0.0	45.82	1.02	0.0	49.9	0.0	0.0	0.0	0.0	0.0	0.0	0.0	0.0	0.0	0.0	0.0	0.0	0.06	0.0	2.92	0.37	0.0	14.28	0.31	0.0	16.28	0.28	0.0	16.42
70057.59016627035	49664.43	204095.76841590274	8.657574323198496	6.27	39.10236045512263	5.07	5.07	0.0	0.28	0.0	87.72	0.0	0.0	4.0	0.28	0.0	87.72	0.14	0.0	45.96	0.76	0.0	50.66	0.0	0.0	0.0	0.0	0.0	0.0	0.0	0.0	0.0	0.0	0.0	0.0	0.07	0.0	2.99	0.28	0.0	14.56	0.19	0.0	16.47	0.22	0.0	16.64
70974.12536977757	67017.9	208051.99378568024	8.643065568665753	6.27	41.47542602378838	5.07	5.07	0.0	0.31	0.0	88.03	0.0	0.0	4.0	0.31	0.0	88.03	0.13	0.0	46.09	0.73	0.0	51.39	0.0	0.0	0.0	0.0	0.0	0.0	0.0	0.0	0.0	0.0	0.0	0.0	0.07	0.0	3.06	0.21	0.0	14.77	0.2	0.0	16.67	0.25	0.0	16.89
85163.77229262693	80374.26	212841.50607830723	12.985524567954501	15.39	39.07095059174288	5.05	5.05	0.0	0.51	0.0	88.54	0.0	0.0	4.0	0.51	0.0	88.54	0.31	0.0	46.4	0.76	0.0	52.15	0.0	0.0	0.0	0.0	0.0	0.0	0.0	0.0	0.0	0.0	0.0	0.0	0.05	0.0	3.11	0.25	0.0	15.02	0.15	0.0	16.82	0.31	0.0	17.2
81328.25324233597	69699.4	224470.35932064307	9.053513451040741	7.41	40.714464042783625	5.06	5.06	0.0	0.33	0.0	88.87	0.0	0.0	4.0	0.33	0.0	88.87	0.16	0.0	46.56	0.87	0.0	53.02	0.0	0.0	0.0	0.0	0.0	0.0	0.0	0.0	0.0	0.0	0.0	0.0	0.05	0.0	3.16	0.36	0.0	15.38	0.23	0.0	17.05	0.23	0.0	17.43
89307.58628232098	92666.76	221111.18560296387	9.03544691550324	7.98	41.769910958286864	5.06	5.06	0.0	0.38	0.0	89.25	0.0	0.0	4.0	0.38	0.0	89.25	0.23	0.0	46.79	0.82	0.0	53.84	0.0	0.0	0.0	0.0	0.0	0.0	0.0	0.0	0.0	0.0	0.0	0.0	0.04	0.0	3.2	0.27	0.0	15.65	0.35	0.0	17.4	0.16	0.0	17.59
86739.81788373765	76325.17	231525.83348670165	7.11403218986751	3.42	45.46394314815441	5.04	5.04	0.0	0.29	0.0	89.54	0.0	0.0	4.0	0.29	0.0	89.54	0.14	0.0	46.93	0.92	0.0	54.76	0.0	0.0	0.0	0.0	0.0	0.0	0.0	0.0	0.0	0.0	0.0	0.0	0.04	0.0	3.24	0.31	0.0	15.96	0.31	0.0	17.71	0.26	0.0	17.85
91456.8097245747	77270.99	245711.6532112763	7.721141653226412	5.13	48.05508480138081	5.05	5.05	0.0	0.3	0.0	89.84	0.0	0.0	4.0	0.3	0.0	89.84	0.18	0.0	47.11	0.75	0.0	55.51	0.0	0.0	0.0	0.0	0.0	0.0	0.0	0.0	0.0	0.0	0.0	0.0	0.05	0.0	3.29	0.23	0.0	16.19	0.21	0.0	17.92	0.26	0.0	18.11
96439.55850711018	69610.23	272540.98171838647	6.973709919932819	0.0	55.02879472131361	5.04	5.04	0.0	0.17	0.0	90.01	0.0	0.0	4.0	0.17	0.0	90.01	0.16	0.0	47.27	0.92	0.0	56.43	0.0	0.0	0.0	0.0	0.0	0.0	0.0	0.0	0.0	0.0	0.0	0.0	0.02	0.0	3.31	0.31	0.0	16.5	0.36	0.0	18.28	0.23	0.0	18.34
97413.08783152228	73636.21	296317.8595499087	7.128569801319915	0.0	62.15736452263355	5.09	5.09	0.0	0.19	0.0	90.2	0.0	0.0	4.0	0.19	0.0	90.2	0.17	0.0	47.44	0.8	0.0	57.23	0.0	0.0	0.0	0.0	0.0	0.0	0.0	0.0	0.0	0.0	0.0	0.0	0.09	0.0	3.4	0.17	0.0	16.67	0.29	0.0	18.57	0.25	0.0	18.59
98471.89154425365	60612.45	334177.3010941625	6.7348283825526005	0.0	68.89219290518615	5.05	5.05	0.0	0.15	0.0	90.35	0.0	0.0	4.0	0.15	0.0	90.35	0.12	0.0	47.56	0.86	0.0	58.09	0.0	0.0	0.0	0.0	0.0	0.0	0.0	0.0	0.0	0.0	0.0	0.0	0.05	0.0	3.45	0.32	0.0	16.99	0.27	0.0	18.84	0.22	0.0	18.81
98707.04387527067	56791.78	376092.5649694332	5.870216250695903	0.0	74.76240915588203	5.08	5.08	0.0	0.12	0.0	90.47	0.0	0.0	4.0	0.12	0.0	90.47	0.08	0.0	47.64	0.88	0.0	58.97	0.0	0.0	0.0	0.0	0.0	0.0	0.0	0.0	0.0	0.0	0.0	0.0	0.08	0.0	3.53	0.33	0.0	17.32	0.25	0.0	19.09	0.22	0.0	19.03
108340.6243835333	124736.28	359696.909352966	6.430821402921689	0.0	81.19323055880375	5.05	5.05	0.0	0.22	0.0	90.69	0.0	0.0	4.0	0.22	0.0	90.69	0.17	0.0	47.81	0.99	0.0	59.96	0.0	0.0	0.0	0.0	0.0	0.0	0.0	0.0	0.0	0.0	0.0	0.0	0.04	0.0	3.57	0.26	0.0	17.58	0.42	0.0	19.51	0.27	0.0	19.3
102449.47991802904	78121.27	384025.11927099526	5.804164901180255	0.0	86.997395459984	5.04	5.04	0.0	0.13	0.0	90.82	0.0	0.0	4.0	0.13	0.0	90.82	0.1	0.0	47.91	0.76	0.0	60.72	0.0	0.0	0.0	0.0	0.0	0.0	0.0	0.0	0.0	0.0	0.0	0.0	0.04	0.0	3.61	0.19	0.0	17.77	0.24	0.0	19.75	0.29	0.0	19.59
108599.32434888594	121945.21	370679.2336198812	5.677412814177306	0.0	92.67480827416128	5.04	5.04	0.0	0.19	0.0	91.01	0.0	0.0	4.0	0.19	0.0	91.01	0.14	0.0	48.05	0.64	0.0	61.36	0.0	0.0	0.0	0.0	0.0	0.0	0.0	0.0	0.0	0.0	0.0	0.0	0.04	0.0	3.65	0.21	0.0	17.98	0.23	0.0	19.98	0.16	0.0	19.75
108426.14504234242	100033.24	379072.13866222376	5.73408435762941	0.0	98.40889263179068	5.04	5.04	0.0	0.16	0.0	91.17	0.0	0.0	4.0	0.16	0.0	91.17	0.13	0.0	48.18	0.61	0.0	61.97	0.0	0.0	0.0	0.0	0.0	0.0	0.0	0.0	0.0	0.0	0.0	0.0	0.04	0.0	3.69	0.17	0.0	18.15	0.19	0.0	20.17	0.21	0.0	19.96
112074.15458238701	89341.67	401804.62324461085	5.764129300896164	0.0	104.17302193268684	5.05	5.05	0.0	0.13	0.0	91.3	0.0	0.0	4.0	0.13	0.0	91.3	0.13	0.0	48.31	0.77	0.0	62.74	0.0	0.0	0.0	0.0	0.0	0.0	0.0	0.0	0.0	0.0	0.0	0.0	0.04	0.0	3.73	0.23	0.0	18.38	0.29	0.0	20.46	0.21	0.0	20.17
117762.70488673952	97228.14	422339.18813135027	5.941934783469771	0.0	110.11495671615663	5.12	5.12	0.0	0.16	0.0	91.46	0.0	0.0	4.0	0.16	0.0	91.46	0.15	0.0	48.46	0.95	0.0	63.69	0.0	0.0	0.0	0.0	0.0	0.0	0.0	0.0	0.0	0.0	0.0	0.0	0.11	0.0	3.84	0.29	0.0	18.67	0.32	0.0	20.78	0.23	0.0	20.4
113471.1208938974	61819.5	473990.809025248	5.74968679020351	0.0	115.86464350636015	5.11	5.11	0.0	0.1	0.0	91.56	0.0	0.0	4.0	0.1	0.0	91.56	0.1	0.0	48.56	0.88	0.0	64.57	0.0	0.0	0.0	0.0	0.0	0.0	0.0	0.0	0.0	0.0	0.0	0.0	0.11	0.0	3.95	0.21	0.0	18.88	0.25	0.0	21.03	0.31	0.0	20.71
111307.33091703375	76747.7	508550.439942282	5.532223284052709	0.0	121.39686679041277	5.07	5.07	0.0	0.1	0.0	91.66	0.0	0.0	4.0	0.1	0.0	91.66	0.05	0.0	48.61	0.88	0.0	65.45	0.0	0.0	0.0	0.0	0.0	0.0	0.0	0.0	0.0	0.0	0.0	0.0	0.07	0.0	4.02	0.32	0.0	19.2	0.2	0.0	21.23	0.29	0.0	21.0
113930.51952620002	134218.72	488262.23946848186	5.516108146095482	0.0	126.9129749365083	5.04	5.04	0.0	0.18	0.0	91.84	0.0	0.0	4.0	0.18	0.0	91.84	0.09	0.0	48.7	0.76	0.0	66.21	0.0	0.0	0.0	0.0	0.0	0.0	0.0	0.0	0.0	0.0	0.0	0.0	0.03	0.0	4.05	0.2	0.0	19.4	0.27	0.0	21.5	0.26	0.0	21.26
111768.69362819137	149146.92	450884.01309667365	5.37419653568807	0.0	132.28717147219632	5.05	5.05	0.0	0.18	0.0	92.02	0.0	0.0	4.0	0.18	0.0	92.02	0.04	0.0	48.74	0.86	0.0	67.07	0.0	0.0	0.0	0.0	0.0	0.0	0.0	0.0	0.0	0.0	0.0	0.0	0.04	0.0	4.09	0.2	0.0	19.6	0.37	0.0	21.87	0.25	0.0	21.51
113003.06478904502	95252.69	468634.38788571884	5.352782051035551	0.0	137.6399535232319	5.07	5.07	0.0	0.11	0.0	92.13	0.0	0.0	4.0	0.11	0.0	92.13	0.03	0.0	48.77	0.8	0.0	67.87	0.0	0.0	0.0	0.0	0.0	0.0	0.0	0.0	0.0	0.0	0.0	0.0	0.07	0.0	4.16	0.25	0.0	19.85	0.25	0.0	22.12	0.23	0.0	21.74
113584.2586625983	119950.36	462268.28654831665	5.52972899175258	0.0	143.16968251498443	5.06	5.06	0.0	0.14	0.0	92.27	0.0	0.0	4.0	0.14	0.0	92.27	0.03	0.0	48.8	0.88	0.0	68.75	0.0	0.0	0.0	0.0	0.0	0.0	0.0	0.0	0.0	0.0	0.0	0.0	0.06	0.0	4.22	0.24	0.0	20.09	0.26	0.0	22.38	0.32	0.0	22.06
119848.75306258601	133636.24	448480.799610903	5.626473375138454	0.0	148.79615589012295	5.03	5.03	0.0	0.16	0.0	92.43	0.0	0.0	4.0	0.16	0.0	92.43	0.07	0.0	48.87	0.78	0.0	69.53	0.0	0.0	0.0	0.0	0.0	0.0	0.0	0.0	0.0	0.0	0.0	0.0	0.03	0.0	4.25	0.31	0.0	20.4	0.2	0.0	22.58	0.24	0.0	22.3
117129.90328599431	95252.69	470358.01289689745	5.340512404147952	0.0	154.1366682942709	5.11	5.11	0.0	0.11	0.0	92.54	0.0	0.0	4.0	0.11	0.0	92.54	0.03	0.0	48.9	0.79	0.0	70.32	0.0	0.0	0.0	0.0	0.0	0.0	0.0	0.0	0.0	0.0	0.0	0.0	0.1	0.0	4.35	0.21	0.0	20.61	0.28	0.0	22.86	0.2	0.0	22.5
118379.43191035435	104420.28	484317.164807252	5.419384702009662	0.0	159.5560529962805	5.05	5.05	0.0	0.12	0.0	92.66	0.0	0.0	4.0	0.12	0.0	92.66	0.03	0.0	48.93	0.89	0.0	71.21	0.0	0.0	0.0	0.0	0.0	0.0	0.0	0.0	0.0	0.0	0.0	0.0	0.04	0.0	4.39	0.28	0.0	20.89	0.32	0.0	23.18	0.25	0.0	22.75
120783.25179825236	126332.25	478768.1666055042	5.40008371467282	0.0	164.95613671095333	5.06	5.06	0.0	0.15	0.0	92.81	0.0	0.0	4.0	0.15	0.0	92.81	0.06	0.0	48.99	0.74	0.0	71.95	0.0	0.0	0.0	0.0	0.0	0.0	0.0	0.0	0.0	0.0	0.0	0.0	0.06	0.0	4.45	0.22	0.0	21.11	0.3	0.0	23.48	0.16	0.0	22.91
117549.91267627994	91675.9	504642.17928178445	5.503200430830618	5.7	164.75933714178387	5.03	5.02	0.01	0.13	0.0	92.94	0.01	0.0	4.01	0.13	0.0	92.94	0.01	0.0	49.0	0.83	0.0	72.78	0.0	0.0	0.0	0.0	0.0	0.0	0.0	0.0	0.0	0.0	0.0	0.0	0.03	0.0	4.48	0.29	0.0	21.4	0.26	0.0	23.74	0.25	0.0	23.16
119517.50704451097	128346.26	495813.4263262952	6.335287073429897	9.5	161.59462421521383	5.06	4.86	0.21	0.19	0.0	93.13	0.06	0.0	4.07	0.19	0.0	93.13	0.06	0.0	49.06	0.8	0.0	73.58	0.0	0.0	0.0	0.0	0.0	0.0	0.0	0.0	0.0	0.0	0.0	0.0	0.06	0.0	4.54	0.24	0.0	21.64	0.24	0.0	23.98	0.26	0.0	23.42
112152.27956678704	98979.89	508985.8158930823	6.011545126353793	22.8	144.80616934156762	5.04	4.48	0.77	0.23	0.0	93.36	0.06	0.0	4.13	0.23	0.0	93.36	0.07	0.0	49.13	0.75	0.0	74.33	0.0	0.0	0.0	0.0	0.0	0.0	0.0	0.0	0.0	0.0	0.0	0.0	0.04	0.0	4.58	0.24	0.0	21.88	0.24	0.0	24.22	0.23	0.0	23.65
109075.02238267144	155849.03	462211.80827575346	6.573501805054151	24.7	126.6796711466217	5.04	4.09	1.72	0.3	0.0	93.66	0.11	0.0	4.24	0.3	0.0	93.66	0.11	0.0	49.24	0.69	0.0	75.02	0.0	0.0	0.0	0.0	0.0	0.0	0.0	0.0	0.0	0.0	0.0	0.0	0.04	0.0	4.62	0.24	0.0	22.12	0.18	0.0	24.4	0.23	0.0	23.88
97878.5049819495	137513.85	422576.4632577031	7.176231046931407	32.3	101.55590219355318	5.02	3.3	3.44	0.32	0.0	93.98	0.18	0.0	4.42	0.32	0.0	93.98	0.18	0.0	49.42	0.51	0.0	75.53	0.0	0.0	0.0	0.0	0.0	0.0	0.0	0.0	0.0	0.0	0.0	0.0	0.01	0.0	4.63	0.15	0.0	22.27	0.16	0.0	24.56	0.19	0.0	24.07
75004.3864259928	100843.49	396737.35968369624	6.073747292418774	45.6	62.029649485971895	5.0	2.3	6.14	0.35	0.0	94.33	0.18	0.0	4.6	0.35	0.0	94.33	0.18	0.0	49.6	0.32	0.0	75.85	0.0	0.0	0.0	0.0	0.0	0.0	0.0	0.0	0.0	0.0	0.0	0.0	0.0	0.0	4.63	0.13	0.0	22.4	0.07	0.0	24.63	0.12	0.0	24.19
49994.34888086643	55005.54	391726.16856456274	3.264324909747292	17.1	48.193974395719195	5.03	1.78	9.39	0.15	0.0	94.48	0.07	0.0	4.67	0.15	0.0	94.48	0.07	0.0	49.67	0.27	0.0	76.12	0.0	0.0	0.0	0.0	0.0	0.0	0.0	0.0	0.0	0.0	0.0	0.0	0.02	0.0	4.65	0.09	0.0	22.49	0.09	0.0	24.72	0.07	0.0	24.26
43345.513357400705	73340.72	361730.9619219633	2.989025270758122	17.1	34.08299966647732	5.0	1.44	12.95	0.17	0.0	94.65	0.07	0.0	4.74	0.17	0.0	94.65	0.07	0.0	49.74	0.27	0.0	76.39	0.0	0.0	0.0	0.0	0.0	0.0	0.0	0.0	0.0	0.0	0.0	0.0	0.0	0.0	4.65	0.11	0.0	22.6	0.1	0.0	24.82	0.06	0.0	24.32
31353.365342960282	9167.59	383916.7372649237	1.5636101083032485	7.6	28.046609774780567	5.0	1.27	16.68	0.05	0.0	94.7	0.01	0.0	4.75	0.05	0.0	94.7	0.01	0.0	49.75	0.17	0.0	76.56	0.0	0.0	0.0	0.0	0.0	0.0	0.0	0.0	0.0	0.0	0.0	0.0	0.0	0.0	4.65	0.06	0.0	22.66	0.06	0.0	24.88	0.05	0.0	24.37
31929.702238267142	36670.36	379176.0795031909	1.9513501805054148	5.7	24.297959955285982	5.02	1.18	20.52	0.07	0.0	94.77	0.03	0.0	4.78	0.07	0.0	94.77	0.03	0.0	49.78	0.22	0.0	76.78	0.0	0.0	0.0	0.0	0.0	0.0	0.0	0.0	0.0	0.0	0.0	0.0	0.01	0.0	4.66	0.07	0.0	22.73	0.06	0.0	24.94	0.08	0.0	24.45
29974.09833935018	36670.36	372479.8178425411	1.9512563176895301	1.9	24.34921627297551	5.01	1.05	24.48	0.05	0.0	94.82	0.04	0.0	4.82	0.05	0.0	94.82	0.04	0.0	49.82	0.15	0.0	76.93	0.0	0.0	0.0	0.0	0.0	0.0	0.0	0.0	0.0	0.0	0.0	0.0	0.01	0.0	4.67	0.06	0.0	22.79	0.02	0.0	24.96	0.06	0.0	24.51
22947.627436823106	18335.18	377092.2652793643	1.3388086642599277	0.0	25.688024937235436	5.02	0.87	28.63	0.02	0.0	94.84	0.02	0.0	4.84	0.02	0.0	94.84	0.02	0.0	49.84	0.15	0.0	77.08	0.0	0.0	0.0	0.0	0.0	0.0	0.0	0.0	0.0	0.0	0.0	0.0	0.01	0.0	4.68	0.03	0.0	22.82	0.06	0.0	25.02	0.05	0.0	24.56
22003.72678700361	55005.54	344090.4520663677	1.8771263537906133	0.0	27.56515129102605	5.0	0.6	33.03	0.06	0.0	94.9	0.06	0.0	4.9	0.06	0.0	94.9	0.06	0.0	49.9	0.09	0.0	77.17	0.0	0.0	0.0	0.0	0.0	0.0	0.0	0.0	0.0	0.0	0.0	0.0	0.0	0.0	4.68	0.06	0.0	22.88	0.0	0.0	25.02	0.03	0.0	24.59
12940.163610108302	27502.77	329527.8456764761	1.0357906137184114	0.0	28.600941904744456	5.0	0.38	37.65	0.03	0.0	94.93	0.03	0.0	4.93	0.03	0.0	94.93	0.03	0.0	49.93	0.07	0.0	77.24	0.0	0.0	0.0	0.0	0.0	0.0	0.0	0.0	0.0	0.0	0.0	0.0	0.0	0.0	4.68	0.03	0.0	22.91	0.02	0.0	25.04	0.02	0.0	24.61
10135.900649819492	36670.36	302993.38632629556	1.031682310469314	0.0	29.632624215213774	5.01	0.23	42.43	0.04	0.0	94.97	0.04	0.0	4.97	0.04	0.0	94.97	0.04	0.0	49.97	0.02	0.0	77.26	0.0	0.0	0.0	0.0	0.0	0.0	0.0	0.0	0.0	0.0	0.0	0.0	0.01	0.0	4.69	0.01	0.0	22.92	0.0	0.0	25.04	0.0	0.0	24.61
3959.6376895306853	18335.18	288617.8440158263	0.4675740072202166	0.0	30.10019822243399	5.0	0.07	47.36	0.02	0.0	94.99	0.02	0.0	4.99	0.02	0.0	94.99	0.02	0.0	49.99	0.01	0.0	77.27	0.0	0.0	0.0	0.0	0.0	0.0	0.0	0.0	0.0	0.0	0.0	0.0	0.0	0.0	4.69	0.0	0.0	22.92	0.01	0.0	25.05	0.0	0.0	24.61
1133.3126353790612	0.0	289751.1566512053	0.048267148014440424	0.0	30.148465370448424	5.0	0.05	52.31	0.0	0.0	94.99	0.0	0.0	4.99	0.0	0.0	94.99	0.0	0.0	49.99	0.0	0.0	77.27	0.0	0.0	0.0	0.0	0.0	0.0	0.0	0.0	0.0	0.0	0.0	0.0	0.0	0.0	4.69	0.0	0.0	22.92	0.0	0.0	25.05	0.0	0.0	24.61
1400.662527075812	9167.59	281984.22917828115	0.20965342960288808	0.0	30.35811880005131	5.0	0.01	57.3	0.01	0.0	95.0	0.01	0.0	5.0	0.01	0.0	95.0	0.01	0.0	50.0	0.0	0.0	77.27	0.0	0.0	0.0	0.0	0.0	0.0	0.0	0.0	0.0	0.0	0.0	0.0	0.0	0.0	4.69	0.0	0.0	22.92	0.0	0.0	25.05	0.0	0.0	24.61
0.0	0.0	281984.22917828115	0.0	0.0	30.35811880005131	5.0	0.0	62.3	0.0	0.0	95.0	0.0	0.0	5.0	0.0	0.0	95.0	0.0	0.0	50.0	0.0	0.0	77.27	0.0	0.0	0.0	0.0	0.0	0.0	0.0	0.0	0.0	0.0	0.0	0.0	0.0	0.0	4.69	0.0	0.0	22.92	0.0	0.0	25.05	0.0	0.0	24.61
0.0	0.0	281984.22917828115	0.0	0.0	30.35811880005131	5.0	0.0	67.3	0.0	0.0	95.0	0.0	0.0	5.0	0.0	0.0	95.0	0.0	0.0	50.0	0.0	0.0	77.27	0.0	0.0	0.0	0.0	0.0	0.0	0.0	0.0	0.0	0.0	0.0	0.0	0.0	0.0	4.69	0.0	0.0	22.92	0.0	0.0	25.05	0.0	0.0	24.61
0.0	0.0	281984.22917828115	0.0	0.0	30.35811880005131	5.0	0.0	72.3	0.0	0.0	95.0	0.0	0.0	5.0	0.0	0.0	95.0	0.0	0.0	50.0	0.0	0.0	77.27	0.0	0.0	0.0	0.0	0.0	0.0	0.0	0.0	0.0	0.0	0.0	0.0	0.0	0.0	4.69	0.0	0.0	22.92	0.0	0.0	25.05	0.0	0.0	24.61
0.0	0.0	281984.22917828115	0.0	0.0	30.35811880005131	5.0	0.0	77.3	0.0	0.0	95.0	0.0	0.0	5.0	0.0	0.0	95.0	0.0	0.0	50.0	0.0	0.0	77.27	0.0	0.0	0.0	0.0	0.0	0.0	0.0	0.0	0.0	0.0	0.0	0.0	0.0	0.0	4.69	0.0	0.0	22.92	0.0	0.0	25.05	0.0	0.0	24.61
0.0	0.0	281984.22917828115	0.0	0.0	30.35811880005131	5.0	0.0	82.3	0.0	0.0	95.0	0.0	0.0	5.0	0.0	0.0	95.0	0.0	0.0	50.0	0.0	0.0	77.27	0.0	0.0	0.0	0.0	0.0	0.0	0.0	0.0	0.0	0.0	0.0	0.0	0.0	0.0	4.69	0.0	0.0	22.92	0.0	0.0	25.05	0.0	0.0	24.61
0.0	0.0	281984.22917828115	0.0	0.0	30.35811880005131	5.0	0.0	87.3	0.0	0.0	95.0	0.0	0.0	5.0	0.0	0.0	95.0	0.0	0.0	50.0	0.0	0.0	77.27	0.0	0.0	0.0	0.0	0.0	0.0	0.0	0.0	0.0	0.0	0.0	0.0	0.0	0.0	4.69	0.0	0.0	22.92	0.0	0.0	25.05	0.0	0.0	24.61
0.0	0.0	281984.22917828115	0.0	0.0	30.35811880005131	5.0	0.0	92.3	0.0	0.0	95.0	0.0	0.0	5.0	0.0	0.0	95.0	0.0	0.0	50.0	0.0	0.0	77.27	0.0	0.0	0.0	0.0	0.0	0.0	0.0	0.0	0.0	0.0	0.0	0.0	0.0	0.0	4.69	0.0	0.0	22.92	0.0	0.0	25.05	0.0	0.0	24.61
0.0	0.0	281984.22917828115	0.0	0.0	30.35811880005131	5.0	0.0	97.3	0.0	0.0	95.0	0.0	0.0	5.0	0.0	0.0	95.0	0.0	0.0	50.0	0.0	0.0	77.27	0.0	0.0	0.0	0.0	0.0	0.0	0.0	0.0	0.0	0.0	0.0	0.0	0.0	0.0	4.69	0.0	0.0	22.92	0.0	0.0	25.05	0.0	0.0	24.61
0.0	0.0	281984.22917828115	0.0	0.0	30.35811880005131	5.0	0.0	102.3	0.0	0.0	95.0	0.0	0.0	5.0	0.0	0.0	95.0	0.0	0.0	50.0	0.0	0.0	77.27	0.0	0.0	0.0	0.0	0.0	0.0	0.0	0.0	0.0	0.0	0.0	0.0	0.0	0.0	4.69	0.0	0.0	22.92	0.0	0.0	25.05	0.0	0.0	24.61
